11111111111111111111111111111111111
10000000000000000000000000000000001
10000000000000000000000000000000001
10000000000P00000000000P0000000001
10000000000000000000000000000000001
100000000000000009000000000000P0001
10000000000000000000000000000000001
10000000000000000000000000000000001
1000000000P000000P000000000000G0001
10000000000000000000000000000000G01
10000000000000000G0000000000000G001
11111111111111100000111111111111111
1BBBBBB000000000000000000000BBBBBB1
1BBBBBB0000000000H0000000000BBBBBB1
1BBBBBB000P00000000000000000BBBBBB1
1BBBBBB000000000000000000000BBBBBB1
1BBBBBB0000000000000000P0000BBBBBB1
1BBBBBB000000000000000000P00BBBBBB1
1BBBBBB000000000000000000000BBBBBB1
22222222222222223332222222222222222
23333333333333333333333333333333332
23222222222222223332222222222222332
23333333333333P33333333333333332332
23222222322222223332222222222322332
23233332333333333333333333332333332
23232322222222222222222222222322332
23233333333333P33333333333333322332
23222222222222222222222222223322332
23333333333333333333333333333322332
2322222222222222222222222222233D332
22222222222222222222222222222222222

