11111111111111111111111111111111111
10000000000000000000000000000000001
10000V00000000000000000000000GG0001
10000000000000000000000000000000001
10000000000P0000000000000000000GG01
10000000000000000000000000000000001
10000000000000090000000000000000001
10000000000000000000000000000000001
10000000G00000000000000V0000000GG01
10000000000000000000000000000000001
10000V00000000000000000000000000001
111111111111111100001111111111111111
10000000000000000000000000000000001
10000000000000000000000000000000001
10000000000P000000000000000000000G1
10000000000000Y0000000000V000000001
10000000000H000000000000000000000G1
10000000000000000000000000G0000GG01
10000000000000000000G000000000000G1
10000000000000000000000000000000001
10000000000000000000000000000000001
111111111111111D11111111111111111111
